0000000000000000000000!
1111101111110111111000!
0000101000010100001000!
0000101000010100001000!
0111101011110101111000!
0100001010000101000000!
0100001010000101000000!
0100001010000101000000!
0111111011111101111111!
0000000000000000000000!
