0000000000000000000000000000!
1111101111110111111000000000!
0000101000010100001000000000!
0000101000010100001000000000!
0111101011110101111000000000!
0100001010000101000000000000!
0100001010000101000000000000!
0100001010000101000000000000!
0111111011111101111111000000!
0000000000000000000000000000!
